9 10 10 10 10 10 10 10 10 11
21 22 22 22 22 22 22 22 22 23
21 22 22 22 22 22 22 22 22 23
21 22 22 22 22 22 22 22 22 23
21 22 22 22 22 22 22 22 22 23
21 22 22 22 22 22 22 22 22 23
21 22 22 22 22 22 22 22 22 23
21 22 22 22 22 22 22 22 22 23
21 22 22 22 22 22 22 22 22 23
33 34 34 34 34 34 34 34 34 35