0 1 1 1 1 1 1 1 1 5
6 -1 -1 -1 -1 -1 -1 -1 -1 11
6 -1 -1 -1 -1 -1 -1 -1 -1 11
6 -1 -1 -1 -1 -1 -1 -1 -1 11
6 -1 -1 -1 -1 -1 -1 -1 -1 11
6 -1 -1 -1 -1 -1 -1 -1 -1 11
6 -1 -1 -1 -1 -1 -1 -1 -1 11
6 -1 -1 -1 -1 -1 -1 -1 -1 11
6 -1 -1 -1 -1 -1 -1 -1 -1 -1
6 14 14 14 14 14 14 14 14 11