2 10 10

-1 -1 -1 -1 -1 -1 -1 -1 -1 -1
-1 16 16 16 16 16 16 16 16 -1
-1 16 16 16 16 16 16 16 16 -1
-1 16 16 16 16 16 16 16 16 -1
-1 16 16 16 16 16 16 16 16 -1
-1 16 16 16 16 16 16 16 16 -1
-1 16 16 16 16 16 16 16 16 -1
-1 16 16 16 16 16 16 16 16 -1
-1 16 16 16 16 16 16 16 16 -1
-1 -1 -1 -1 -1 -1 -1 -1 -1 -1

0 1 1 1 1 1 1 1 1 5
6 -1 -1 -1 -1 -1 -1 -1 -1 11
6 -1 -1 -1 -1 -1 -1 -1 -1 11
6 -1 -1 -1 -1 -1 -1 -1 -1 11
6 -1 -1 -1 -1 -1 -1 -1 -1 11
6 -1 -1 -1 -1 -1 -1 -1 -1 11
6 14 14 -1 -1 -1 -1 -1 -1 11
6 -1 -1 14 14 -1 -1 -1 -1 11
6 -1 -1 -1 -1 14 14 -1 -1 11
6 14 14 14 14 14 14 14 14 11